1111111111111111111111111111111111111
1000000000000000000000000000000000001
100X000000000000000000000000000000001
1111111111111111111111111100001111111
1000000000000000000000000000000000001
1000000000000100000000000000000000001
1001111111111111111111111111111100001
1000000000000010000000000000000000001
1111111111100010000000000000000000001
1000000000000010000000000000000000001
1001111111111111111111111111111111111
1001000000000000000000000000000000001
1001000000000000000000000000000000001
1001000111111111111111111111111100001
1001000100000000000000000000000100001
1001000100000000000000000000000100001
1001000100001111111111111111000100001
1001000100000000000000000001000100001
1001000100000000000000000001000100001
1001000111111111111111111111000100001
1001000000000000000000000000000100001
1001000000000000000000000000000100001
1001111111111111111111111111111100001
1000000000000000000000000000000000001
1000000000000000000000000000000000001
1111111111111111111111111111111111111
